#############################################################
||                                                         ||
||                                                         ||
||                                      ............       ||
||                                                         ||
||                                                         ||      
||    ...............                                      ||
||                                                         ||
||        |%%%%%%%%%%%%%|                                  ||
||                                  |%|                    ||
||         .................        |%|                    ||
||                                  |%|                    ||
||                                  |%|                    ||
||                                  |%|   ...........      ||
||                                  |%%%%%%%%%%%%%%%%|     ||
||                                                         ||
||                                                         ||
||           ..............                                ||
||           |%%%%%%%%%%%%%%%|                             ||
||                                                         ||
||                      ...............................    ||
||                                                         ||
#############################################################
